############################################################
############################################################
############################################################
############################################################
############################################################
############################################################
##############..############################################
##############..############################################
#############...############################################
######..#####.#.############################################
#####...#####.#.############################################
#####.#.#####.#.############################################
#####.#.#####.#.######..####################################
####..#.#####.#..#####..####################################
####.##..####.##..##...>####################################
####.###.###..###.##....####################################
##................##....####################################
##.<....#.#.............####################################
##..................###...##################################
##..................#####.##################################
#..######################.#.<###############################
#..######################.#..###############################
#########################.#..###############################
#########################....###############################
##########################...########################..#####
##########################...########################..#####
############################..######################.....###
#############################.##########..##########.#..>###
#############################.##########..##########.#...###
#############################.##..######..#######........###
#############################.....##..##..##..###........###
###############################...##..##......##....#.#..###
###############################...##..##.####.##.#........##
#################################..#.....####....#......#.##
##################################.#.#############....#.#.##
##################################.#.#############..#...#.##
##################################.#.#############.#....#..#
##################################...#############......####
############################################################
############################################################
