############################################################
############################################################
############################################################
############################################################
############################################################
############################################################
############################################################
############################################################
############################################################
############################################################
############################################################
############################################################
############################################################
############################################################
############################################################
############################################################
############################################################
############################################################
#.....###..#################################################
#.###..##..#############...#################################
#.####.##..#############.#.#################################
#.####.##...############.#.#################################
#...........############.#..##############################.#
#......#....############.##.##############################.#
#...#.......############.##..#############################.#
#....#.......###########.###..###################...######.#
#............##########.<####.###################.#..#####.#
#..#...####..##########.#####.###################.##..####.#
######.####....########.#####.###################.###.....@#
######...#.....########.#####..##################...#..##..#
########.#.##..##..#....######.#####..#######..#...........#
########.#.##..##..#.#########.#####..#######..#.#.........#
########.#.##..##......######...####..#######..#.#.........#
########.#.##..##....#.######...........#####..#.#.####.#.<#
########.#.##........#.######.#...##.<..#..##..#.#.####....#
########...##........#.######.#...##....#..##...<........#<#
################.....#..#####.###.....#.#.........#.#......#
#######################.......#######............#...#...#.#
###############################################............#
############################################################
